####################
#--#---#--#--------#
#--#---#----#---##-#
#--##------#-------#
#-#----##--##-#-##-#
#----#---##---#----#
##-#-###-##-###-#-##
#--#------------#--#
#-##-#-##--##-#-##-#
#----#-#----#-#-#--#
#-##-##########----#
#----#--------#-#--#
##-#-#-######-#-#-##
#--#-----###-------#
#--#-###-##--##-#--#
##-#-----##---#-#-##
#----#--####--#----#
#-##-##--##--##-##-#
#------------------#
####################
