####################
#--#---#--#------#-#
#--#---#--#-#---##-#
#--##-##--##-------#
#-------#---#-#-##-#
#----#---##---#----#
##-#-###-##-###-#-##
#--#------------#--#
#-##-#-##--##-#-##-#
#----#-#----#-#-#--#
#-##-#-##-#####----#
#---------------#--#
#--#-####-###-#-##-#
#--#-----###----#--#
#--#-###-##--##-#--#
####----------#-####
#----#--####--#----#
#-##-##--##--##-##-#
#------------------#
####################
